1111311111133311
5        1     1
5              1
5        1     3
1111141112     1
1        1     1
1A             2
1  1111111111551
6  6666666666666
6         6    6
6     6        6
66666666666    6
77777777777    7
7     7        7
7          7   7
7777777777777777



